#傳	𫝊 傳
#剾	𠛅 剾
#勁	𠡍 勁
#啐	𠯥 啐
#囋	𡂐 囋
#埣	𡉻 埣
#塿	𪣻 塿
#壗	𡋤 壗
#壠	𡏡 壠
#孻	𡥧 孻
#寠	𪧘 寠
#嶞	𡺆 嶞
#挳	𢫞 挳
#捽	𢪄 捽
#撥	𫝼 撥
#擣	𢭏 擣
#攏	𢲣 攏
#斅	𢽾 斅
#晬	𣅢 晬
#櫷	𪳥 櫷
#欓	𣗋 欓
#灙	𣺼 灙
#烴	𤇂 烴
#硜	𥑋 硜
#篸	𥮾 篸
#縷	𫃵 縷
#脛	𦙾 脛
#臍	𦜝 臍
#蕟	𫈴 蕟
#謳	𧦅 謳
#讜	𧫆 讜
#貗	𫎌 貗
#踁	𨀃 踁
#躋	𨂋 躋
#轝	𨊮 轝
#遱	𫐷 遱
#鋞	𫒔 鋞
#鏒	𨨕 鏒
#鏤	𨩐 鏤
#陘	𫔽 陘
#隮	𫕅 隮
#隴	𨻫 隴
#麬	𤿲 麬
#鼬	𫠘 鼬
#𩯁	𫙂 𩯁
乘	乗 乘
亂	乱 亂
亙	亘 亙
亞	亜 亞
仿	倣 仿
佔	占 佔
佛	仏 佛
來	来 來
俠	侠 俠
俱	倶 俱
倅	伜 倅
值	値 值
假	仮 假
傳	伝 傳
傴	伛 傴
僂	偻 僂
僞	偽 僞
價	価 價
儉	倹 儉
儔	俦 儔
儕	㑪 儕
儘	侭 儘
儹	儧 儹
儻	傥 儻
兒	児 兒
兔	兎 兔
內	内 內
兩	両 兩
册	冊 册
冰	氷 冰
凜	凛 凜
剁	刴 剁
剝	剥 剝
剩	剰 剩
劍	剣 劍
劑	剤 劑
勞	労 勞
勱	劢 勱
勳	勲 勳
勵	励 勵
勸	勧 勸
區	区 區
卷	巻 卷
卻	却 卻
厲	厉 厲
參	参 參
吞	呑 吞
吳	呉 吳
呣	嘸 呣
咒	呪 咒
啞	唖 啞
單	単 單
嘍	喽 嘍
嘔	呕 嘔
嘜	唛 嘜
噓	嘘 噓
嚙	噛 嚙
嚮	向 嚮
嚴	厳 嚴
囑	嘱 囑
圈	圏 圈
國	国 國
圍	囲 圍
圓	円 圓
圖	図 圖
團	団 團
垛	垜 垛
埓	埒 埓
堯	尭 堯
增	増 增
墮	堕 墮
壓	圧 壓
壘	塁 壘
壞	壊 壞
壤	壌 壤
壯	壮 壯
壹	壱 壹
壺	壷 壺
壽	寿 壽
奧	奥 奧
奩	奁 奩
奬	奨 奬
妝	粧 妝
姊	姉 姊
姬	姫 姬
娛	娯 娛
媼	媪 媼
嫗	妪 嫗
孃	嬢 孃
學	学 學
寢	寝 寢
實	実 實
寫	写 寫
寬	寛 寬
寶	宝 寶
將	将 將
專	専 專
對	対 對
屆	届 屆
屢	屡 屢
屬	属 屬
峽	峡 峽
崢	峥 崢
嵾	㟥 嵾
嶁	嵝 嶁
嶇	岖 嶇
#嶼	屿 嶼
嶽	岳 嶽
巑	㠝 巑
巖	巌 巖
巢	巣 巢
帶	帯 帶
幓	㡎 幓
幬	帱 幬
廢	廃 廢
廣	広 廣
廳	庁 廳
强	強 强
彈	弾 彈
彌	弥 彌
彎	弯 彎
彥	彦 彥
徑	径 徑
從	従 從
徠	徕 徠
徵	徴 徵
德	徳 德
恆	恒 恆
悅	悦 悅
悴	忰 悴
惠	恵 惠
惡	悪 惡
惱	悩 惱
慍	愠 慍
慘	惨 慘
慪	怄 慪
慺	㥪 慺
慾	欲 慾
應	応 應
懤	㤽 懤
懷	懐 懷
懺	懴 懺
戀	恋 戀
戰	戦 戰
戲	戯 戲
戶	戸 戶
戾	戻 戾
拂	払 拂
拔	抜 拔
拜	拝 拜
挾	挟 挾
掙	挣 掙
插	挿 插
揭	掲 揭
搔	掻 搔
搖	揺 搖
搜	捜 搜
搵	揾 搵
摑	掴 摑
摟	搂 摟
摳	抠 摳
摻	掺 摻
擇	択 擇
擊	撃 擊
擔	担 擔
據	拠 據
擠	㨈 擠
擧	挙 擧
擴	拡 擴
攜	携 攜
攝	摂 攝
攢	攅 攢
攪	撹 攪
收	収 收
效	効 效
敕	勅 敕
敘	叙 敘
數	数 數
斆	敩 斆
斷	断 斷
晉	晋 晉
晚	晩 晚
晝	昼 晝
曆	暦 曆
曉	暁 曉
曠	昿 曠
曾	曽 曾
會	会 會
朵	朶 朵
查	査 查
栃	杤 栃
栅	柵 栅
桌	卓 桌
桝	枡 桝
條	条 條
棧	桟 棧
椊	枠 椊
榮	栄 榮
榲	榅 榲
槮	椮 槮
樂	楽 樂
樓	楼 樓
樞	枢 樞
樣	様 樣
橢	楕 橢
#橢	椭 橢
橫	横 橫
檜	桧 檜
檢	検 檢
檮	梼 檮
檳	梹 檳
櫟	檪 櫟
櫠	廃 櫠
櫨	枦 櫨
櫳	槞 櫳
櫻	桜 櫻
權	権 權
欑	櫕 欑
歐	欧 歐
歟	欤 歟
歡	歓 歡
步	歩 步
歧	岐 歧
歲	歳 歲
歷	歴 歷
歸	帰 歸
殘	残 殘
殲	殱 殲
殼	殻 殼
毆	殴 毆
每	毎 每
毿	毵 毶 毿
氛	雰 氛
氣	気 氣
污	汚 污
沒	没 沒
涉	渉 涉
淚	涙 淚
淥	渌 淥
淨	浄 淨
淬	㳃 淬
淺	浅 淺
渴	渇 渴
溪	渓 溪
溫	温 溫
溼	湿 溼
滯	滞 滯
滲	渗 滲
滿	満 滿
漊	溇 漊
漚	沤 漚
潑	溌 潑
潛	潜 潛
澀	渋 澀
澁	渋 澁
澤	沢 澤
濕	湿 濕
濜	浕 濜
濟	済 濟
濤	涛 濤
濱	浜 濱
瀆	涜 瀆
瀧	滝 瀧
瀨	瀬 瀨
灌	潅 灌
灒	濽 灒
灣	湾 灣
焰	焔 焰
熅	煴 熅
燈	灯 燈
燒	焼 燒
營	営 營
燼	烬 燼
燾	焘 燾
爐	炉 爐
爭	争 爭
爲	為 爲
爾	尓 爾
牀	床 牀
犧	犠 犧
狀	状 狀
狹	狭 狹
猙	狰 猙
獎	奨 獎
獨	独 獨
獵	猟 獵
獸	獣 獸
獻	献 獻
瑤	瑶 瑤
瓔	珱 瓔
瓚	瓉 瓚
瓣	弁 瓣
甌	瓯 甌
產	産 產
畫	画 畫
當	当 當
疇	畴 疇
疊	畳 疊
疏	疎 疏
瘁	疩 瘁
瘦	痩 瘦
瘮	瘆 瘮
瘻	瘘 瘻
癈	㾱 癈
癘	疠 癘
癡	痴 癡
發	発 發
盜	盗 盜
盡	尽 盡
眍	眍 眍
眞	真 眞
眾	衆 眾
睜	睁 睜
瞜	䁖 瞜
碎	砕 碎
磣	碜 磣
礦	砿 鉱 礦
礪	砺 礪
祕	秘 祕
祿	禄 祿
禪	禅 禪
禮	礼 禮
禰	祢 禰
禱	祷 禱
稅	税 稅
稱	称 稱
稻	稲 稻
穇	䅟 穇
穎	頴 穎
穗	穂 穗
穩	穏 穩
穰	穣 穰
窗	窓 窗
窶	窭 窶
竈	竃 竈
竊	窃 竊
箏	筝 箏
簍	篓 簍
簞	箪 簞
籌	筹 籌
籠	篭 籠
粹	粋 粹
糝	糁 糝
絕	絶 絕
絲	糸 絲
經	経 經
綠	緑 綠
綷	紣 綷
緣	縁 緣
縕	緼 縕
縣	県 縣
縱	縦 縱
總	総 總
繡	繍 繡
繩	縄 繩
繪	絵 繪
繫	繋 繫
繼	継 繼
纃	緕 纃
續	続 續
纖	繊 纖
纘	纉 纘
缺	欠 缺
欠缺	欠缺
罐	缶 罐
翠	翆 翠
耬	耧 耬
聯	連 聯
聰	聡 聰
聲	声 聲
聽	聴 聽
肅	粛 肅
脣	唇 脣
脫	脱 脫
腦	脳 腦
腳	脚 腳
膃	腽 膃
膽	胆 膽
臟	臓 臟
臺	台 臺
與	与 與
舉	挙 舉
舊	旧 舊
舍	舎 舍
舖	舗 舖
艫	舮 艫
艷	艶 艷
莊	荘 莊 庄
莖	茎 莖
萊	莱 萊
萬	万 萬
蒕	蒀 蒕
蔘	参 蔘
蔞	蒌 蔞
蔣	蒋 蔣
薰	薫 薰
薵	䓓 薵
薺	萕 薺
藎	荩 藎
藏	蔵 藏
藝	芸 藝
藥	薬 藥
藪	薮 藪
蘂	蕊 蘂
蘆	芦 蘆
處	処 處
虛	虚 虛
號	号 號
蛵	蛏 蛵
螢	蛍 螢
螻	蝼 螻
蟬	蝉 蟬
蟲	虫 蟲
蠅	蝿 蠅
蠆	虿 蠆
蠟	蝋 蠟
蠣	蛎 蠣
蠶	蚕 蠶
蠻	蛮 蠻
裝	装 裝
褸	褛 褸
襄	㐮 襄
襌	褝 襌
覺	覚 覺
覽	覧 覽
觀	観 觀
觸	触 觸
說	説 說
諫	諌 諫
謠	謡 謠
證	証 證
譖	譛 譖
譯	訳 譯
譽	誉 譽
讀	読 讀
變	変 變
讓	譲 讓
讚	讃 讚
豐	豊 豐
豫	予 豫
豬	猪 豬
貓	猫 貓
貙	䝙 貙
貳	弐 貳
賣	売 賣
賤	賎 賤
賴	頼 賴
贊	賛 贊
贐	䝲 贐
趲	䟎 趲
跺	跥 跺
踐	践 踐
躉	趸 躉
躊	踌 躊
躲	躱 躲
軀	躯 軀
輕	軽 輕
輛	輌 輛
轀	輼 轀
轉	転 轉
轟	軣 轟
辨	弁 辨
辭	辞 辭
辯	弁 辯
遙	遥 遙
遞	逓 遞
遲	遅 遲
邁	迈 邁
邇	迩 邇
邊	辺 邊
鄉	郷 鄉
鄕	郷 鄕
酇	鄼 酇
醉	酔 醉
醞	醖 醞
醫	医 醫
醬	醤 醬
醱	醗 醱
釀	醸 釀
釋	釈 釋
銳	鋭 銳
錄	録 錄
錢	銭 錢
鍊	錬 鍊
鐵	鉄 鐵
鐸	鈬 鐸
鑄	鋳 鑄
鑛	鉱 鑛
鑪	鈩 鑪
鑽	鑚 鑽
钂	鎲 钂
閱	閲 閱
關	関 關
附	付 附
陷	陥 陷
隨	随 隨
險	険 險
隯	陦 隯
隱	隠 隱
隸	隷 隸
雙	双 雙
雜	雑 雜
雞	鶏 雞
霸	覇 霸
靈	霊 靈
靜	静 靜
靱	靭 靱
頰	頬 頰
頸	頚 頸
顏	顔 顏
顯	顕 顯
餘	余 餘
馱	駄 馱
騷	騒 騷
驅	駆 驅
驒	騨 驒
驗	験 驗
驛	駅 驛
髏	髅 髏
髓	髄 髓
體	体 體
髮	髪 髮
鬥	闘 鬥
鬪	闘 鬪
鰮	鰛 鰮
鰺	鯵 鰺
鶫	鶇 鶫
鶯	鴬 鶯
鷄	鶏 鷄
鷗	鴎 鷗
鹼	鹸 鹼
鹽	塩 鹽
麥	麦 麥
麩	麸 麩
麴	麹 麴
麵	麺 麵
黃	黄 黃
黑	黒 黑
默	黙 默
點	点 點
黨	党 黨
黲	黪 黲
鼠	鼡 鼠
齊	斉 齊
齋	斎 齋
齒	歯 齒
齡	齢 齡
齧	噛 齧
龍	竜 龍
龜	亀 龜
龝	穐 龝
粵	粤 粵
鄰	隣 鄰
